20
33333333333333333333
31111111111111111113
31111111111111111113
31111111111111111113
31111111111111111113
31111111111333331113
31111111111111111113
31111111111111111113
33333333111111111113
31111111111111111113
31111111111111111113
31111111111111111113
31111111111111111113
31111111111333333333
31111111111111111113
31111111111111111113
31111111111111111113
31111133111111111113
31111111111111111113
33333333333333333333