11
11111111111
11111333111
11111111111
11111111111
11111111111
11111133331
11111111111
11133311111
11111111111
33333111111
11133333333