03000300000
00000000000
00000000000
00000033300
00000000000
00000000000
00000000000
00033333000
00000000000
00000000000
00000000000